C 200,5,0
F 5,0,100 

EA assets/textures/east_texture.png
NO assets/textures/north_texture.png
SO assets/textures/south_texture.png
WE assets/textures/west_texture.png

1111111
10N1001
1010001
1000001
1111111