C 255,255,255
F 5,99,88 

EA assets/textures/east_texture.png
NO assets/textures/north_texture.png
SO assets/textures/south_texture.png
WE assets/textures/west_texture.png

1111111
1000001
10000000000000000001
10000000000000000000000001
11111111111111111E00001
11111111111111111111111