C 255,255,255
F 5,99,88 

EA assets/textures/east_texture.xpm
NO assets/textures/north_texture.xpm
SO assets/textures/south_texture.xpm
WE assets/textures/west_texture.xpm


111111111111111111111111111111111
10000000001S100000000000000000001
100000000000000000000000000000001
100000000010001000000000000000001
100000000000100000000000000000001
100000000000000000000011100000001
111111111111111111111111111111111
