C 255,255,255
F 5,99,88 

EA assets/textures/east_texture.png
NO assets/textures/north_texture.png
SO assets/textures/south_texture.png
WE assets/textures/west_texture.png


111111111111111111111111111111111
100000000000000000000000000000001
100000000000000000000000000000001
100000000010001000000000000000001
100000000000100000000000000000001
1000000000000000000000000000000S1
111111111111111111111111111111111
