
 
C 174, 212, 246
F  139,90,43


 WE assets/textures/greystone.xpm
 EA assets/textures/mossy.xpm
 NO assets/textures/north_texture.xpm
 SO assets/textures/south_texture.xpm             

 1111111111111111111111111111111111111111111
100000000000000000000000000000000000000000001
10000000000000000000000000000000000000011111
1000000000000000000000000000000000000001
1000000000000000000000000000000000000001
1000000000000000001010000000000000000001
1000000000000000001010000000000000000001
1000000000000000001N10010000000000000001
1000000000000000001110010000000000000001
1000000000000000000000000000000000000001
1000000000000000000000000000000000000001
1000000000000000000000000000000000000001
1000000000000000000000000000000000000001
1000000000000000000000000000000000000001
 11111111111111111111111111111111111111






