R 800 800
NO assets/textures/wood.xpm
SO assets/textures/colorstone.xpm
WE assets/textures/greystone.xpm
EA assets/textures/greystone.xpm

F 52, 63,73 
C 174, 212, 246

1111111111111111111111111111111111111111111111111111111
1001000000E000000000000000000000000000000000000000000001
10000000000000000101111111111100000000000000000000000001
 111000000000000001           10010000100000000100010001
    100111000000001            100100001000000100010001
 111000000000000000111111       1001000010000100010001
10000100011111100100000001       10010000100100010001
 1111000000000000100000001        100100001000010001
     10011111110000011111          1001000000010001
 1111000000000000001                11010000010001
10000100011111100001                 100100010001
 111000000000000000111111             1000000001
    100000000000010000001              10011001
11110000001000000000000001111111111111110000000111111111
100000001111100000100000000000000000000000000000000000001
 1110000000000000011111111111110000100000000011100000001
    100011100000001            100000011111000000000001
 111000000000000000111111       1000000000000000000001
10000100001111000000000001       10011000011111100001
 1111000000000000100000001        100000000000000001
     10001100000000011111          1000011110000001
 1111000000111100001                10000000000001
10000100000000000001                 100001111001
 111000000111100000111111             1000000001
    100000000000010000001              10000001
     1111111111111111111                100001
                                         1111
                                         1111