NO assets/textures/north_texture2.xpm
SO assets/textures/south_texture1.xpm
EA assets/textures/east_texture1.xpm
WE assets/textures/west_texture1.xpm


C 207,231,149
F 247,239,129

11111111111111111
10000000000000001
10100000100000101
10000000000000001
10001000100010001
10000000000000001
1010101N001010101
10000000000111111
10001000100000001
10000000000111111
10100000100001001
10000000000000001
11111111111111111