R 500 500
NO tests/textures/wall.xpm
SO tests/textures/bricks.xpm
WE tests/textures/gold.xpm
EA tests/textures/wood.xpm
S tests/textures/enemy.xpm
F 220,111,119
C 225,111,256

 11111111111111111111111111111111111111
1000000000000000000000000000000000000001
1000000000000000000000000000000000000001
1000000000000000000000000000000000000001
1000000000000000000000000000000000000001
1000000000000000001110000000000000000001
1000000000000000001010000000000000000001
1000000000000000001S10010000000000000001
1000000000000000001110010000000000000001
1000000000000000000000000000000000000001
1000000000000000000000000000000000000001
1000000000000000000000000000000000000001
1000000000000000000000000000000000000001
1000000000000000000000000000000000000001
 11111111111111111111111111111111111111