
NO tests/textures/wal.xpm
SO tests/textures/bricks.xpm
WE tests/textures/gold.xpm
EA tests/textures/wood.xpm

F 220,111,119
C 225,111,200

 11111111111111111111111111111111111111
1000000000000000001000000000000000000001
1000000000000000001000000000000000000001
1000000000000000001000000000000000000001
1000000000000000001000000000000000000001
1000000000000000001010000000000000000001
1000000000000000001010000000000000000001
1000000000000000001010010000000000000001
1000000000000000001110010000000000000001
1000000000000000000000000000000000000001
1000000000000000000000000000000000000001
1000000000000000000000000000000000000001
1000000000000000000000000000000000000001
1000000000000000000000000000000000000001
 111111111111111111N1111111111111111111