R 800 800
F 255, 0,      95

NO assets/textures/greystone.xpm
SO assets/textures/greystone.xpm


C 225, 111, 200

WE assets/textures/greystone.xpm
EA assets/textures/greystone.xpm


 11111
 1NS11
 11111