NO assets/textures/greystone.xpm
SO assets/textures/greystone.xpm
WE assets/textures/greystone.xpm
EA assets/textures/greystone.xpm

F 220,111,119
C 225,111,200


 11111111111111111111111111111111111111
1000000000000000001000000000000000000001
1000000000000000001000000000000000000001
1000000000000000001000000000000000000001
1000000000000000001000000000000000000001
1000000000000000001011110000000000000001
1000000000000000001010010000000000000001
1000000000000000001E10010000000000000001
1000000000000000001110010000000000000001
1000000000000000000000010000000000000001
1000000000000000000000010000000000000001
1000000000000000000000010000000000000001
1000000000000000000000010000000000000001
10000000000000000000000S0000000000000001
 11111111111111111111111111111111111111