

NO assets/textures/greystone.xpm
SO assets/textures/greystone.xpm
WE assets/textures/greystone.xpm
EA assets/textures/greystone.xpm

F 220,111,119
C 225,111,200

 1111111111111111111111111111111111111111111
100000000000000000100000000000000000000000001
1000000000000000001000000000000000000001
1000000000000000001000000000000000000001
1000000000000000001000000000000000000001
1000000000000000001010000000000000000001
1000000000000000001010000000000000000001
1000000000000000001N10010000000000000001
1000000000000000001110010000000000000001
1000000000000000000000000000000000000001
1000000000000000000000000000000000000001
1000000000000000000000000000000000000001
1000000000000000000000000000000000000001
1000000000000000000000000000000000000001
 11111111111111111111111111111111111111