
NO assets/textures/eagle,xpm
SO assets/textures/eagle.xpm
WE assets/textures/eagle.xpm
EA assets/textures/eagle.xpm

F 220,111,119
C 225,111,255

 111111111111111111111111111111111111111111111
100000000000000000000000000000000000000      1
1000000000000000000000000000000000000001111111
1000000000000000000000000000000000000001
1000000000000000000000000000000000000001
1000000000000000001010000000000000000001
1000000000000000001010000000000000000001
1000000000000000001N10010000000000000001
1000000000000000001110010000000000000001
1000000000000000000000000000000000000001
1000000000000000000000000000000000000001
1000000000000000000000000000000000000001
1000000000000000000000000000000000000001
1000000000000000000000000000000000000001
 11111111111111111111111111111111111111