R 500 500
F 255, 0,      95

NO assets/textures/greystone.xpm
SO assets/textures/greystone.xpm


C 225, 111, 200

WE assets/textures/greystone.xpm
EA assets/textures/greystone.xpm

F 220,111,119
C 225,111,200

 11111111111111111111111111111111111111
1000000000000000000000000000000000000001
1000000000000000000000000000000000000001
1000000000000000000000000000000000000001
1000000000000000000000000000000000000001
1000000000000000001110000000000000000001
1000000000000000001010000000000000000001
1000000000000000001N10010000000000000001
1000000000000000001110010000000000000001
1000000000000000000000000000000000000001
1000000000000000000000000000000000000001
1000000000000000000000000000000000000001
1000000000000000000000000000000000000001
1000000000000000000000000000000000000001
 11111111111111111111111111111111111111