NO assets/textures/colorstone.xpm
SO assets/textures/colorstone.xpm
WE assets/textures/colorstone.xpm
EA assets/textures/colorstone.xpm

F 100,100,100
C 200,200,200

111111
110 01
10N001
100111
1111 11
