NO ./textures/north.xpm
SO ./textures/south.xpm
WE ./textures/west.xpm
EA ./textures/east.xpm
F 100,100,100
C 200,200,200

111111
1 0 01
10N001
1001
111 11
