
 
C 255,255,255
F 00,00,00



 NO assets/textures/north_texture.xpm
 SO assets/textures/south_texture.xpm                       
 WE assets/textures/west_texture.xpm
 EA assets/textures/east_texture.xpm

111111111111111111111111111111111
1100000000101000000000000000000W1111111111
100000000000000000000000000000000000000001
100000000010001000000000000000001111111111      
100000000000100000000000000000001
100000000000000000000011100000001
1111111111111100000000111111111111111111
111111111111000000000000111111111111
11111111111000000000000000111111111111
111111100000001111111111100111111111111
111111100001111       10011111111111
1111100000011         10000000011111
1111000000001111111111000000111111
1111000000000000000000000000011111
111111111111111111111111111111111


